################################################
#@.............................................#
#.....#.......................#................#
#..............................................#
#.......#......................................#
#..............................................#
#..............#..........#........#...........#
#.........#....................................#
#..............................................#
#..............................................#
#.....#.................................#......#
#................#.............................#
#.......#......................................#
#..............................................#
#..............#..........#........#...........#
#.........#....................................#
#..............................................#
#..............................................#
#.....#.................................#......#
#................#.............................#
#.......#......................................#
#..............................................#
#..............#..........#........#...........#
#.........#....................................#
#..............................................#
#..............................................#
#.....#.................................#......#
#................#.............................#
#..............#..........#........#...........#
#.........#....................................#
#..............................................#
#.............................#................#
#..........#...................................#
#.................#............................#
################################################