################################################
#@.............................................#
#.....#.......................#................#
#..............................................#
#.......#......................................#
#..............................................#
########.......#..........#........#...........#
       #.........#.............................#
       #.......................................#
       #.......................................#################
########................................#......................#      #######
#................#.............................................#      #.....#
#.......#......................................########......###      #.....#
#..............................................#      #......#        #.....#
#..............#..........#........#...........#      #..##..##########.#####
#.........#....................................#      #.................#
#..............................................#      ###################
#..............................................#
#.....#.................................#......#
#................#.............................#
#.......#......................................#
#..............................................#
#..............#..........#........#...........#
#.........#....................................#
#..............................................#
#..............................................#
#.....#.................................#......#
#................#.............................#
#..............#..........#........#...........#
#.........#....................................#
#..............................................#
#.............................#................#
#..........#...................................#
#.................#............................#
################################################