################################################
#@........................w....................#
#.....T........B..........w...T................#
#...................wwwwwww....................#
#.......T..........wwwwwwwww.......B...........#
#...........B......wwwwwwwww...................#
########.......T....wwwwwww...B....T...........#
       #...B.....T.............................#
       #............B..........................#
       #........B.........B....................#################
########................................T......................#      #######
#.........B......T......B......................................#      #.....#
#.......T......................................########......###      #.....#
#..............................................#      #......#        #.....#
#..............T..........T........T...........#      #..##..##########.#####
#.........T....................................#      #.................#
#..............................................#      ###################
#..............................................#
#.....T.................................T......#
#................T.............................#
#.......T......................................#
#..............................................#
#..............T..........T........T...........#
#.........T....................................#
#..............................................#
#..............................................#
#.....T.................................T......#
#................T.............................#
#..............T..........T........T...........#
#.........T....................................#
#..............................................#
#.............................T................#
#..........T...................................#
#.................T............................#
################################################