################################################
#@........................w....................#
#.....T........b..........w...T................#
#...................wwwwwww....................#
#.......T..........wwwwwwwww.......b...........#
#...........b......wwwwwwwww...................#
########.......T....wwwwwww...b....T...........#
       #...b.....T.............................#
       #............b..........................#
       #........b.........b....................#################
########................................T......................#      #######
#.........b......T......b......................................#      #.....#
#.......T......................................########......###      #..B..#
#..............................................#      #......#        #.....#
#..............T..........T........T...........#      #..##..##########.#####
#.........T....................................#      #.................#
#..............................................#      ###################
#..............................................#
#.....T.................................T......#
#................T.............................#
#.......T......................................#
#..............................................#
#..............T..........T........T...........#
#.........T....................................#
#..............................................#
#..............................................#
#.....T.................................T......#
#................T.............................#
#..............T..........T........T...........#
#.........T....................................#
#..............................................#
#.............................T................#
#..........T...................................#
#.................T............................#
################################################